11111111111111
10010100000001
10010100011101
10E00100000101
1000P10001C101
10000100000101
10000100010101
10000100001011
10000100011001
11111111111111
