11111111111111
10010100000CC1
1CC10100011101
10E00100000101
0000P100010101
10000100000101
100C0CCCC10101
1CCC0100001011
10000100011001
11111111111111
